11111111
1P000001
10000001
1C0000E1
11111111
