11111111111111111111111111
1EP0000000000C00000C000001
10110100100000101001010101
10110010101010001001010101
1P00000C00C0000000000000C1
11111111111111111111111111
