111111111111111111111111111111111
1PC0000C000C0CCCC0CCCCCC0CCCCC0E1
10C0000C000C0C0000C0000C0C00000E1
10C0000C000C0C0000CCCCCC0CCCCC0E1
10C0000C000C0C0000C0000C00000C0E1
10CCCC0CCCCC0CCCC0C0000C0CCCCC0E1
111111111111111111111111111111111
